0 1 2 3 4 1 2 3 4 0
1 0 1 2 3 4 3 2 1 0
2 2 0 4 4 0 2 2 0 0
3 0 3 0 3 0 3 0 3 0
4 1 4 1 4 1 4 1 4 1
0 2 0 2 0 2 0 2 0 2
1 3 1 3 1 3 1 3 1 3
2 4 2 4 2 4 2 4 2 4